R  1000 1000
NO           ./textures/north.xpm
SO             ./textures/south.xpm
WE ./textures/west.xpm
EA ./textures/east.xpm
S ./textures/barrel.xpm
F 110,110,60
C 135,206,235

        1111111111111111111111111
        1000000000110000000000001
        1011000001110000002000001
        1001000000000000000000001
111111111011000001110000000000001
100000000011000001110111111111111
11110111111111011100000010001
11110111111111011101010010001
110000001101010111000000000001
10002000000000001100020010201
10000000000000001101010010001
11000001110101011111011110N0111
11110111 1110101 101111010001
11111111 1111111 111111111111
